________________________________________
________________________________________
____________________F___________________
________________________________________
________________________________________
_P____Q__12345678__E____________________
7777777777777777777777777777777777777777
7777777777777777777777777777777777777777
7777777777777777777777777777777777777777