##########################
#________________________#
#________________________#
#____CCCCCCCCCCCCCCCC____#
#____4643165316432511QQQQ#
#____4652111552366412____#
#____4643264356114253____#
#____5643164623232514Q___#
#____4562441242265314Q___#
#_P__5461314251365313Q_F_#
#7878QQQQQQQQQQQQQQQQ7878#
##########################
