###########################################
#_________________________________________#
#_________________________________________#
#_________________________________________#
#_________________________________________#
#_______________6_________________________#
#_____________5___________________________#
#___________4_____________________________#
#_________3_______________________________#
#_______2_________________________________#
#__P__1___________________________________#
#_777_____________________________________#
#______________________________F__________#
#_______________________777777777_________#
###########################################