________________________________________
________________________________________
________________________________________
________________________________________
________________________________________
_P____Q__12345678E_F____________________
7777777777777777777777777777777777777777
7777777777777777777777777777777777777777
7777777777777777777777777777777777777777