###########################################
#_________________________________________#
#_________________________________________#
#_________________________________________#
#_______________C_________________________#
#_____________C_6_________________________#
#___________C_5___________________________#
#_________C_4_____________________________#
#_______C_3_______________________________#
#_____C_2_________________________________#
#__P__1___________________________________#
#_777_____________________________________#
#______________________________F__________#
#_______________________777777777_________#
###########################################
