##########################################
#________________________________________#
#________________________________________#
#________________________________________#
#____C______________________________F____#
#3__777777777777777777777777777777777____#
#2_______________________________________#
#1_______________________________________#
#__6________________6_5_4_3__2_1_4_______#
#____5________C____QQQQQQQQQQQQQQ__3__2__#
#______4______________________________1__#
#__C_____3__2_1_______________________6__#
#_______________________C___________4_5__#
#_______Q__Q__Q__Q__Q__Q__Q_______3______#
#_______________________________2________#
#__P_C__6__5__4__C__3__2__C__1___________#
#7777777777777777777777777777777777777777#
##########################################
