________________________________________
________________________________________
____________________F___________________
________________________________________
________________________________________
_P____Q__12345678_______________________
7777777777777777777777777777777777777777
7777777777777777777777777777777777777777
7777777777777777777777777777777777777777