##########################################
#________________________________________#
#________________________________________#
#________________________________________#
#________________________________________#
#________________________________________#
#______________C__1_2_3_4_5_6C___________#
#_________2_4_5_3___________________F____#
#______C_1__________________7777777777777#
#___77777___C______________________Q_____#
#_________77777____C__________Q__________#
#_________________7777___4_Q_____________#
#__CQ_Q_Q_Q_Q_Q_________3__Q_____________#
#________________C_____2___Q_____________#
#_P_1__2__3__4__5__6__C1___Q_____________#
#7777777777777777777777777777777777777777#
##########################################
