##########################################
#________________________________________#
#________________________________________#
#________________________________________#
#________________________________________#
#________________________________________#
#________________________________________#
#___________Q____________________________#
#________C__Q____________________________#
#________6__Q____________________________#
#_______58__Q____________________________#
#______4Q8__C___C________________________#
#_____3Q_8______5_______________6________#
#____2Q__8_____38____C_______4__Q________#
#_P_1Q___8____1Q8QQQQ_____2__Q__Q___C_F__#
#7777777777777777777777777777777777777777#
##########################################
