##########################################
#________________________________________#
#________________________________________#
#________________________________________#
#________________________________________#
#________________________________________#
#________________________________________#
#___________Q____________________________#
#___________Q____________________________#
#________6__Q____________________________#
#_______58__Q____________________________#
#______4Q8_______________________________#
#_____3Q_8______5_______________6________#
#____2Q__8_____38____________4__Q________#
#_P_1Q___8____1Q8QQQQ_____2__Q__Q_____F__#
#7777777777777777777777777777777777777777#
##########################################
